1 0
1 141 56 95 1 0 779 613 
1 259 134 1 11 9 -11 51 
2104 244 112 
1 2 149 1 33 2 430 51 
2120 2 148 
1 58 183 16 1 7 364 50 
1 117 183 33 1 5 -11 48 
2111 57 150 
2112 116 150 
2112 188 150 
2111 227 150 
